00000000000000000000000000000000
01111111111111000011111111111110
00000001000001000010000010000000
01000001000001000010000010000010
01111111111111111111111111111110
01000001001000000000010010000010
01000001001000000000010010000010
01111111001111100111110011111110
00000001000000100100000010000000
00000001001111111111110010000000
00000001001000000000010010000000
00000001111000000000011110000000
00000001001000000000010010000000
00000001001111111111110010000000
00000001001000000000010010000000
01111111111111100111111111111110
01000001000000100100000010000010
00111001111111111111111110011100
00001001001000000000010010010000
00001001001000000000010010010000
01111111001111100111110011111110
01000000000000100100000000000010
01111111111111111111111111111110
00000000000000000000000000000000